Ecosystem | Cloud | Ubuntu	/cloud/ecosystem/
Ubuntu OIL | Ecosystem | Cloud | Ubuntu	/cloud/ecosystem/ubuntu-oil/
Build a cloud | Cloud | Ubuntu	/cloud/build-a-cloud/
Cloud computing with Ubuntu | Cloud | Ubuntu	/cloud/
Labs | Cloud | Ubuntu	/cloud/labs/
Cloud computing with Ubuntu | Ubuntu	/cloud/contact-us/
Comprehensive tools to build your cloud | Cloud | Ubuntu	/cloud/tools/
Ubuntu cloud Jumpstart | Cloud | Ubuntu	/cloud/tools/jumpstart/
Contact us | Ubuntu Jumpstart | Ubuntu	/cloud/tools/jumpstart/contact-us/
Thank you | Ubuntu	/cloud/tools/jumpstart/thank-you/
MAAS | Cloud | Ubuntu	/cloud/tools/maas/
OpenStack with Ubuntu | Cloud | Ubuntu	/cloud/tools/openstack/
Cloud reference architecture | Cloud  | Ubuntu	/cloud/tools/openstack/reference-architecture/
Cloud installer | Cloud | Ubuntu	/cloud/tools/cloud-installer/
Juju | Cloud | Ubuntu	/cloud/tools/juju/
Use a cloud | Cloud | Ubuntu	/cloud/use-a-cloud/
Cloud management | Cloud | Ubuntu	/cloud/management/
Thank you | Ubuntu	/cloud/thank-you/
Ubuntu at Dell World 2012 | Ubuntu	/2012/11/dellworld/
Ubuntu at HP Discover 2012 | Ubuntu	/2012/11/hpdiscover/
Partners | Ubuntu	/partners/
HP Moonshot and Ubuntu work together | Ubuntu	/partners/hp/moonshot/
HP and Ubuntu | Ubuntu	/partners/hp/
ASUS and Ubuntu | Ubuntu	/partners/asus/
Contact Canonical | Ubuntu	/partners/contact-us/
ARM and Ubuntu | Ubuntu	/partners/arm/
Dell and Ubuntu | Ubuntu	/partners/dell/
Dell XPS 13 Developer Edition - with Ubuntu 12.04 LTS | Ubuntu	/partners/dell/dellxps/
Find a partner | Ubuntu	/partners/find-a-partner/
ISV partners | Ubuntu	/partners/find-a-partner/isv/
Hardware partners | Ubuntu	/partners/find-a-partner/hardware/
Reseller partners | Ubuntu	/partners/find-a-partner/reseller/
Partners | Ubuntu Certified | Ubuntu	/partners/ubuntu-certified/
Certified software | Ubuntu	/partners/ubuntu-certified/software/
IBM and Ubuntu | Ubuntu	/partners/ibm/
Partners | Partner programmes | Ubuntu	/partners/partner-programmes/
Partner services | Ubuntu	/partners/partner-services/
Thank you | Become a partner | Ubuntu	/partners/thank-you/
The world's most popular free OS | Ubuntu	/
Ubuntu on phones | Ubuntu	/phone/
Design and user experience | Ubuntu for phones | Ubuntu	/phone/features/
Contact us | Ubuntu for phones | Ubuntu	/phone/register/
Thank you | Ubuntu for phones | Ubuntu	/phone/register/thank-you/
Contact us | Ubuntu for phones | Ubuntu	/phone/contact-us/
Ubuntu for Android | Ubuntu for phones | Ubuntu	/phone/ubuntu-for-android/
Features and specifications | Ubuntu for Android | Ubuntu for phones | Ubuntu	/phone/ubuntu-for-android/features/
Contact us | Ubuntu for Android | Ubuntu for phones | Ubuntu	/phone/ubuntu-for-android/contact-us/
Thank you | Ubuntu for phones | Ubuntu	/phone/ubuntu-for-android/thank-you/
Carrier Advisory Group | Ubuntu for phones | Ubuntu	/phone/carrier-advisory-group/
App ecosystem | Ubuntu for phones | Ubuntu	/phone/app-ecosystem/
Backed by Canonical | Ubuntu for phones | Ubuntu	/phone/backed-by-canonical/
Operator and OEM partners | Ubuntu for phones | Ubuntu	/phone/operators-and-oems/
Thank you | Ubuntu for phones | Ubuntu	/phone/thank-you/
Ubuntu Advantage Assurance terms | Ubuntu	/ua-assurance-terms/
Dell Ubuntu Advantage Reseller End User Terms | Ubuntu	/ua-dell-tc/
Cloud Archive instruction | Ubuntu	/download/cloud/cloud-archive-instructions/
Download Ubuntu Server for cloud | Download | Ubuntu	/download/cloud/
Installing Ubuntu Cloud | Ubuntu	/download/cloud/install-ubuntu-cloud/
Download Ubuntu | Ubuntu	/download/cloud/thank-you/
Download Ubuntu | Ubuntu	/download/
Download Ubuntu Server for ARM | Ubuntu	/download/arm/
Download Ubuntu Server | Ubuntu	/download/server/
Download Ubuntu Server | Ubuntu	/download/server/download/
Canonical Stor	/download/server/cds/
Installing Ubuntu Server | Ubuntu	/download/server/install-ubuntu-server/
Download Ubuntu | Ubuntu	/download/server/thank-you/
Alternative downloads | Ubuntu	/download/alternative-downloads/
Ubuntu 桌面版 | Ubuntu	/download/zh-CN/
How to burn a DVD on OS X | Ubuntu	/download/desktop/burn-a-dvd-on-mac-osx/
Download Ubuntu Desktop | Ubuntu	/download/desktop/windows-installer/
Download Ubuntu Desktop | Ubuntu	/download/desktop/
Install Ubuntu 13.10 | Ubuntu	/download/desktop/install-ubuntu-desktop/
Contribute to Ubuntu | Ubuntu	/download/desktop/contribute/
Try Ubuntu before you install it | Ubuntu	/download/desktop/try-ubuntu-before-you-install/
How to create a bootable USB stick on Ubuntu | Ubuntu	/download/desktop/create-a-usb-stick-on-ubuntu/
Upgrade Ubuntu | Ubuntu	/download/desktop/upgrade/
How to burn a DVD on Ubuntu | Ubuntu	/download/desktop/burn-a-dvd-on-ubuntu/
Installing Ubuntu with the Windows installer | Ubuntu	/download/desktop/install-ubuntu-with-windows/
How to create a bootable USB stick on Windows | Ubuntu	/download/desktop/create-a-usb-stick-on-windows/
How to create a bootable USB stick on OS X | Ubuntu	/download/desktop/create-a-usb-stick-on-mac-osx/
Download Ubuntu | Ubuntu	/download/desktop/thank-you/
Install Ubuntu 13.10 | Ubuntu	/download/desktop/install-desktop-latest/
How to burn a DVD on Windows | Ubuntu	/download/desktop/burn-a-dvd-on-windows/
Install Ubuntu 14.04.3 LTS | Ubuntu	/download/desktop/install-desktop-long-term-support/
Ubuntu Advantage Service Description | Ubuntu	/ua-servicedescription/
Trademark policy | Ubuntu	/intellectual-property-policy/
Landscape features | Management | Ubuntu	/management/landscape-features/
Management | Ubuntu	/management/
Ubuntu Advantage | Management | Ubuntu	/management/ubuntu-advantage/
Working with Landscape | Management | Ubuntu	/management/working-with-landscape/
Contact Canonical | Management | Ubuntu	/management/contact-us/
Return on investment | Management | Ubuntu	/management/return-on-investment/
Compliance | Management | Ubuntu	/management/compliance/
404	/management/cloud-management/
Thank you | Management | Ubuntu	/management/thank-you/
Enterprise Class Ubuntu Management with Canonical Landscape | Ubuntu	/management/ema-whitepaper/
Ubuntu TV | Ubuntu	/tv/
Contributing to Ubuntu TV | Ubuntu TV | Ubuntu	/tv/contributors/
Experience Ubuntu TV | Ubuntu TV | Ubuntu	/tv/experience/
Commercial info | Ubuntu TV | Ubuntu	/tv/commercial-info/
Made for the TV industry | Ubuntu TV | Ubuntu	/tv/industry/
TV features and specifications | Ubuntu TV | Ubuntu	/tv/features-and-specs/
Canonical and Ubuntu | Ubuntu	/about/canonical-and-ubuntu/
About the Ubuntu project | Ubuntu	/about/
Leadership | About Ubuntu | Ubuntu	/about/about-ubuntu/old-leadership-conduct/
Ubuntu Code of Conduct v2.0 | Ubuntu	/about/about-ubuntu/conduct/
About Ubuntu | Ubuntu	/about/about-ubuntu/
Ubuntu and Debian | About Ubuntu | Ubuntu	/about/about-ubuntu/ubuntu-and-debian/
Governance | About Ubuntu | Ubuntu	/about/about-ubuntu/governance/
Derivatives | About Ubuntu | Ubuntu	/about/about-ubuntu/derivatives/
Our Philosophy | About Ubuntu | Ubuntu	/about/about-ubuntu/our-philosophy/
Licensing | About Ubuntu | Ubuntu	/about/about-ubuntu/licensing/
Diversity | About Ubuntu | Ubuntu	/about/about-ubuntu/diversity/
Contact us | Ubuntu	/about/contact-us/
Contact us | Ubuntu	/about/contact-us/form/
Thank you | Ubuntu	/about/contact-us/form/thank-you/
Ubuntu Font | Ubuntu	/about/ubuntu-font/
Ubuntu on tablets | Ubuntu	/tablet/
Contact us | Ubuntu for tablets | Ubuntu	/tablet/register/
Thank you | Ubuntu for tablets | Ubuntu	/tablet/register/thank-you/
Contact us | Ubuntu for tablets | Ubuntu	/tablet/contact-us/
App ecosystem | Ubuntu for tablets | Ubuntu	/tablet/app-ecosystem/
Backed by Canonical | Ubuntu for tablets | Ubuntu	/tablet/backed-by-canonical/
Ready to roll | Ubuntu on tablets | Ubuntu	/tablet/operators-and-oems/
Thank you | Ubuntu for tablets | Ubuntu	/tablet/thank-you/
Legal | Ubuntu	/legal/
Ubuntu online accounts | Ubuntu	/legal/online-accounts/
Ubuntu testing | Ubuntu	/info/testing/
Release end of life | Ubuntu	/info/release-end-of-life/
		<title>Ubuntu online tour	/tour/en/
		<title>Ubuntu 在线体验	/tour/zh-CN/
Ubuntu Server - for scale-out computing | Ubuntu	/server/
Server services | Server | Ubuntu	/server/hyperscale/
Contact us | Ubuntu Server | Ubuntu	/server/contact-us/
Server management | Ubuntu	/server/management/
Thank you | Ubuntu	/server/thank-you/
Support | Ubuntu	/support/
Privacy Policy | Ubuntu	/privacy-policy/
Third-party privacy policies | Ubuntu	/privacy-policy/third-parties/
Ubuntu phone press pack | Ubuntu	/2013/01/press-pack-ubuntu-phone/
Ubuntu Edge founders page | Ubuntu	/2013/07/edge-founders/
Ubuntu Edge press pack | Ubuntu	/2013/07/press-pack-ubuntu-edge/
Ubuntu tablet press pack | Ubuntu	/2013/02/press-pack-ubuntu-tablet/
Ubuntu tablet press pack | Ubuntu	/2013/02/press-pack-ubuntu-tablet/faq/
Ubuntu at Dell World 2012 | Ubuntu	/2013/02/dellfrs/
The world's most popular free OS | Ubuntu	/
Take the tour | Ubuntu	/desktop/take-the-tour-gallery/
Meet Ubuntu | Ubuntu	/desktop/
Contact us | Ubuntu	/desktop/contact-us/
Office applications | Features | Ubuntu	/desktop/features/office-applications/
Games and apps | Features | Ubuntu	/desktop/features/games-apps/
Web browsing | Features | Ubuntu	/desktop/features/web-browsing/
Features | Ubuntu	/desktop/features/
Music and mobile | Features | Ubuntu	/desktop/features/music-and-mobile/
Photos and videos | Features | Ubuntu	/desktop/features/photos-and-videos/
Ubuntu One is your personal cloud | Features | Ubuntu	/desktop/features/personal-cloud/
Social and email | Features | Ubuntu	/desktop/features/social-and-email/
Take the tour | Ubuntu	/desktop/take-the-tour/
China's own Ubuntu | Ubuntu	/desktop/ubuntu-kylin/
Business as usual | Desktop | Ubuntu	/desktop/business/
中国的Ubuntu | Ubuntu	/desktop/ubuntu-kylin-chinese/
Desktop management | Ubuntu	/desktop/management/
Thank you | Ubuntu	/desktop/thank-you/
Desktop for developers | Ubuntu	/desktop/developers/
Desktop for developers | Ubuntu	/desktop/developers/thin-client/
